string	set(string)	array(string)
pppppppp	["pppp", "ppp", "pp"]	["pppp", "pppp"]	TODO
esgh	["gh", "es", "esg"]	["es", "gh"]	TODO
pzzzzzzzzzzzzzzzzzzzzzzzzzzzzzzzzzzzzzzzzzzzzzzzzzzzzzzzzzzzzzzzzzzzzzzzzzzzzzzzzzzzzzzzzzzzzzzzzzzzzzzzzzzzzzzzzzzzzzzzzzzzzzzzzzzzzzzzzzzzzzzzzzzzzzz	["zz", "zzzzzz", "zzzzzzzzzz", "zzzzzzz", "zzz", "z", "zzzzzzzz", "zzzzzzzzz", "zzzz", "zzzzz"]	[]	TODO
sssssss	["sss", "ssss"]	["sss", "ssss"]	TODO
gddhdsjjdlosddgelrtisvwrgidjjrgvodgjwvihwhvvrvjgsawegstiwewergwveaasoprlrpggpwhvgpojlpjhvoojletrvga	["slvjlihagwioiow", "s", "elrtisvwr", "itswjrpgehw", "rpggpwhvgpoj", "loglwljorgit", "hvagdsihrpltgte", "gddhdsjjdlosddg", "aoj", "ah", "ogrohso", "dsvwdpliiwjoe", "depsrlotav", "irrlda", "j", "hsprhho", "ogerpgattgso", "dgviglh", "hh", "l", "errjvejhvjjlase", "driveljaovgtv", "vvhitjgd", "sheddrhiaj", "hiilsogrdiha", "ssetjohegjtij", "eopwtlolh", "wdjwastldalrda", "rgvodgjw", "st", "ollgdeevehp", "wveaasopr", "jj", "joepdd", "lpjhvoojlet", "advg", "ljhlgievgiges", "tt", "lohgwogrrl", "dwetjdww", "wsdgirors", "hpsa", "gv", "twwgeolelrpilra", "gidjj", "vihwhvvrvjgs", "lvtgaralvph", "arr", "rvga", "awegstiwewerg"]	["gddhdsjjdlosddg", "elrtisvwr", "gidjj", "rgvodgjw", "vihwhvvrvjgs", "awegstiwewerg", "wveaasopr", "l", "rpggpwhvgpoj", "lpjhvoojlet", "rvga"]	TODO
vuuietfu	["etfu", "vuui"]	["vuui", "etfu"]	TODO
o	["o"]	["o"]	TODO
vuvw	["vw", "uv"]	[]	TODO
meeeyeey	["ye", "em", "ee", "me"]	[]	TODO
hqusgwarqahcyqfsrduxduxcchiq	["chuxidixac", "iwhmgym", "wsgayusdi", "agiqwamum", "rumgdwcidxyug", "sasrasumqg", "gussgcwgiq", "awcfmycqaaqq", "hdcwuc", "whhaqdsqirmw", "qisdycyhcguuu", "uqwscucy", "rhgascmdsxaf", "fwacgfxx", "qxquywawcrshm", "mduhsfuygfhd", "qsdsafdr", "sfshyfqm", "giuqmhwidwyaiw", "irqwdaix", "fxhd", "hci", "xusd", "gqrrmcrdyqaas", "gygqdcwuxr", "rcyrumxm", "giiwymdd", "yxrqagcdu", "umsadmcrmxhc", "gmixmymrwa", "hgasxdawyqii", "cmqi", "fsfhdiyadg", "iiiwmcfsudigyaa", "syicaxisdiss", "ffccx", "iwhymhqw", "cmmhyqidww", "hxgsghfgfi", "uasdxf", "xwamdmdwfxg", "usgwarqah", "ufyrrcff", "yqmiadrmqsd", "iuqcsrc", "fssussduwc", "wiqxcwx", "wusq", "xrr", "diug", "sximxgas", "wwyydaryqscs", "iwdchsfwm", "qacqsfmhd", "frq", "f", "qduqiymsscsq", "xygiyywcuwa", "qmmhcqaqqdus", "qgxhyum", "cyqfsr", "fagacgrgq", "xcgd", "hdi", "dxwaii", "riiwhxqr", "qsawquwfhxryr", "hgcidxwcdxwqawq", "qmqgughixsa", "awhygxwrdqcfu", "igxc", "quddxuwfugm", "ruufaxxgrfyx", "uwaufgwiacsc", "yafs", "wqm", "cqsuddwidruid", "hq", "mmqfdcrdu", "rhuuiasirhrwdg", "mqxfws", "ua", "dwhyumccch", "duhrg", "fhxydf", "gwqgxiua", "fwyywqqafw", "wg", "uuisasdg", "g", "hcacfd", "sirimwhiu", "fwsyqddxiyiwmmu", "ghhciyifidmady", "frhfxdqdca", "yfrramdyu", "frgdgmhhrsmrgsq", "myiqfqwudh", "axarmymh", "gqssrryq", "mrmdydmfyci", "ggsahcy", "drcxy", "frwrshmucis", "ym", "uhgwxwxumxiyhsh", "yuqxu", "cmsxicfrfwch", "cimdmqhgq", "gxhxgdmirdc", "ccwayaawm", "mxwmudd", "sccaihxsc", "swghgf", "qc", "xuafmdqaai", "fxxwffg", "fgigsryuhh", "umwhcqdaah", "irhmfmr", "rw", "cwqy", "fyamcsuymxdy", "uiwsxxqqdsicym", "ayyuqgurxhiswd", "rifrqfrsgi", "qdxiwrdxgfq", "uicimmc", "ufc", "hcwxqrmfaq", "mqhrdsdihg", "cqffxfmhurm", "hrhrmhgwa", "wcqammfqyid", "ii", "wmmacffaydcu", "hciffsdf", "qhiiii", "qfi", "uumc", "hggguxmf", "sca", "ywssxyxrhddrui", "qhgsgih", "sr", "xwciscafx", "xmdw", "wmyu", "usamdxwhfcqqwii", "gyyqgamuirsfwcf", "mgumwcsycrc", "ury", "gymrscg", "cxrgwuwadh", "qimixwqisr", "dxmfcmwg", "iah", "fhmiairr", "iuhggyifaauucu", "cufdsucarawd", "dgrw", "smsx", "whuygf", "hrhyfiqdhyymdh", "aqguqawrsmyd", "qdrihwucgxh", "hcaxd", "uurfuiuism", "xsfaqxursqc", "aqw", "wdxqifurgy", "afxuxwfrdgdf", "qycsmxudsssmcis", "uasdgwqigqqudc", "hyqwsq", "xf", "ywxaaumrwg", "gfuaahmmu", "uirymgxrxdxc", "hwwhxyxc", "cxhrcxmqf", "umiuuhca", "uiqmrwarr", "aywwaqccmwhy", "yhhmcwxgqhdd", "iryuahqawuuyx", "frc", "fgia", "cyshgxawggxxhqw", "hqgumyd", "hciwchyhgd", "ihsdymcyyyfs", "gdxwfxdcurga", "hxrw", "mhyr", "uqm", "imhsxshhhqdira", "hwrasyqdwfw", "wua", "xmhmxyf", "xihmrdwfmr", "uhcudfdwyhu", "ggqmdmc", "qqw", "cxdhy", "dsih", "iyrxfaydcs", "dhycmymi", "acsuymxfsxud", "cisgyyx", "r", "qxuhsahufi", "ammsrmadqfcwis", "aciwadhhhxcw", "uqfwaxrrwaqrf", "uhumi", "hisfymw", "swiix", "qxiad", "amyfxxcyww", "mhqwfwacfcuycs", "uhxy", "yxdhcgrgcih", "uhguurdwhga", "cuwu", "afia", "ifxrhgrfysfiyh", "yw", "cmudxyxry", "suxhrshx", "id", "uxmfhdihuwdairm", "fm", "cascs", "mamudruxsmw", "yurc", "sxmxyhwyygmgu", "iqwg", "ycmwqi", "usycfchdgmda", "yirgq", "hhfg", "mh", "qwmydgwi", "mshfgqx", "uiasywsqwhmwi", "wdyimwdyxuqgxi", "hxwiugiqfxyd", "hcxdyiu", "iccxdagmhgrgrud", "a", "yfirxaycfwdg", "ds", "midciuc", "xquaxsywuah", "sgdmxx", "xfuhhgm", "ifdg", "iwfswucihhgquw", "gsmmxsgrcd", "yiyysqmrgy", "isqu", "aas", "wrwhfwxwsrcy", "hagxqwwcwausaxr", "qascrwwfwriahi", "diduqrqqxrgxmm", "da", "ahwcrmshxxuyr", "hdcraagyxums", "xfsdsagmauqc", "rmcws", "h", "acdquuxgcmmdhm", "yhwiragdhsuqfyr", "qfhugmgg", "yfwuafyicrsmwrh", "grsuqhhqfuyy", "auxw", "wcrxig", "ddgmwruhxu", "mrqcfmfw", "fcgirudrirumdm", "mhfcfqsiuar", "ufaugximwmir", "xrxrfcmihg", "gamdahdiuffi", "cqwaf", "gquuaxdfqhiimqs", "fshquhiawi", "aauhsxyi", "mfsd", "cxmwgshmqfgfcsm", "wr", "cfhhrcidyhhqs", "mgc", "ufqmggiygyfm", "qafucmxm", "qaqssfuaxdsf", "qrmqsa", "ir", "sqiqwu", "y", "swhuxuaiyys", "xdcri", "uw", "yuxa", "hfw", "sw", "dwsqcffx", "ucuachfqfuudx", "ryicfdaagm", "iahcusu", "icxyhrwqfmqfr", "cxryyx", "yghiiy", "fqq", "wxqwh", "cyhm", "fdrigfcxrmxmhym", "dahwrafxxgifqi", "wgxdwuus", "ywymuhyrcars", "yc", "iqaryqdr", "ccmhyufiqysgc", "crfg", "fcfssfaxdufww", "maqfyasud", "agwhidigcx", "dgychuguhh", "yduixqqhqxy", "ghf", "auggydsd", "dcscruqhhwmy", "wfudfygyudgfhf", "cyfuwrqqiwrmq", "dgsxrf", "srsscaqdxh", "arcxmqih", "rcdccmrccgxh", "if", "wywugguhqhf", "iqq", "uryfac", "agi", "qfhxxwhurimcd", "qrhdacdqw", "rdifdyasaacurfd", "gcyf", "sgxiwsfy", "qyxugyisgcyg", "dsuacs", "qacsmcrmdwqm", "cgdqiygcgirhwwg", "yrcu", "fhfdquada", "xsdu", "uxigmaghisxiac", "imsuqaawaumwwgy", "sgiarmdugdci", "qrraxffwifu", "swharaq", "rymgcwaxgifsqrh", "muawidqqqsd", "ssdrsffc", "ugacaxrcdduuww", "duaauaayd", "cfxsi", "du", "qrmh", "gcim", "cr", "wgimmgihcruyhcm", "mrrwwuyxuahddw", "qacuxx", "imhymqadq", "gxfyfxrq", "sgfasscicwhs", "xdyyf", "grdru", "iag", "mx", "gsuyhq", "cygydqhwax", "cyqaisuhdscmgdq", "gxdgcsfw", "qhmsqxsmsqwd", "qshgqwxycuadmwy", "yshs", "ud", "fcawqmsydx", "ucrax", "uadhayqrw", "ficra", "fyhc", "x", "qsagdwxdiu", "qfcisaxqxmgdq", "gsay", "rcgari", "ihumxydds", "gdffdicwrhq", "dxy", "fcsawhafwg", "ia", "fyhacfwddahs", "xdwcwiguswxas", "duxduxcchiq", "mxwg", "gcwhwh", "sxhrqfaiwmwug", "ggwu", "cduyxadiqgf", "fhcxsmw", "schfrwdc", "wihga", "diwymiyhssgdxr", "fcwmfsmu", "wf", "ca", "qcqamwhgxiamimy", "ahgud", "sfh", "dxrccxxhcig", "ahsfsyggd", "xu", "iagawiw", "saqfxuhmsmmd", "csswwsaqwyayuw", "c", "axixugaffsaf", "qcimyxrhcmgaig", "acycihhmfcgac", "yyyhyqwfddagqxr", "rcgdrchfqcg", "cmhddmhffs", "fcaxuryhgw", "fmrdxsc", "hiaywhi", "sugcfghahfqgdqy", "gix", "dfh", "sdyhsqmaag", "shxsqagryhxwudf", "s", "ryurwcgywgigd", "si", "q", "cyuh", "hgqdi", "cuf", "ucf", "xahharx", "wrsurscaqrsxghq", "cdcuxa", "rmaysrwcw", "fyufhysmiucicag", "d", "ymardg", "csxdgqrww", "aardrm", "xxcryyadfuhxhu", "uf", "iiddq", "chiywsxqxwwi", "wgurwrsdcqs", "wgdwaqfim", "mxwddawxcaguih", "fwuascw", "xhgs", "qfgwuyacxm", "rqsgcrg", "fxdfdi", "dyahisc", "acwdhffyrggiyra", "i", "ruwxxgqssrgr", "siwhydwcrsaar", "dmxcmrwgd", "diimfhydrgsacg", "wifmcms", "iqigusimrfys", "ugcsmhq", "drhc", "xgaagxugicgdsc", "aghsswiimrdgqfu", "xwg", "gfwygyhcfs", "xsidsiufccqs", "rffywmur", "fmhuqaysyqhgrhw", "qsyriuimmrqiidw", "icx", "yucxmqmqgd", "rchxigaqchgy", "umyrq", "wwciiqhwsrf", "qsirydcciruqs", "uhi", "aafhw", "yrrqgfdrry", "wsdw", "sryd", "wwyrhrxi", "xyisfhfyh", "hhcwsmaf", "rywh", "dfc", "aciii", "gwqfxydwxqyausy", "yy", "yqqhurcrgdhh", "qyihss", "xxicixirwi", "dwwchdhffcmqq", "wqydrgysq", "uccmsciq", "hwr", "dmficixscicii", "qfgyfwcmamwic", "urqiggqsrhqihcw", "aayfxcmyygs", "cwrx", "isuqaiudgcy", "samscwqixq", "xfgrqm", "cudm", "qwhcm", "qiqayaqd", "yyywxumdcc", "gs", "gf", "yfi", "ahrmwrudhrcwygd", "qrigdcaxdixiaih", "ah", "urxqf", "wudq", "dqmurhhduii", "msf", "wryfqsqyis", "gqgdaxrqway", "ddcwcacacrqwmq", "w", "acrihrmcfgrrrfc", "fwdaw", "yxmwxwdwmfqs", "dxqciq", "rsi", "wdafmsmcqmw", "mxifd", "am", "rfrmd", "wfrwxqiywcwgaah", "sg", "gqxr", "uwgsisi", "gdhm", "wxiugrs", "smumqhduuhydg", "iwd", "dufiaffyd", "yhdidydrmssrmda", "wqasmugucfdfu", "cxsycxqgficgqcy", "wddcgdd", "ssuuyu", "yuurc", "arshhasyggxxq", "scruacussamssi", "cfuymugw", "yuwwrw", "qmsqfiywrxm", "qagwmusufdh", "rgixhqxmwra", "cgqxmiswfudu", "gmcdiqufdifxms", "whshrrqs", "xaauwsmafgugr", "xgqsamhidgqx", "huwuuddaxhgdiwy", "qdcayud", "mrrqfyhfuaqmy", "fyxrfxq", "fcdwy", "qhs", "xsrwhwsy", "xcyddwih", "sscuqrdryssgu", "mauqdw", "dcfcaq", "rhiha", "icaxuaiirrydh", "xsdmrmmdr", "gy", "cfucwwhwcrrq", "wsxs", "aiwxxgxrq", "ufcsydfuqxdw", "gm", "dxsuxcrui", "rgcs", "adfrmwyawm", "mrg", "grfwixfrguf", "ryfhuwgxig", "uifqm", "ahagrqdcccxqfy", "rayqwchiuc", "iwfsffsm", "qhguawscrhhggg", "iwwuwymyfifa", "uadfx", "wu", "rcm", "uuqmrwmwihqs", "wdrgmhydiug", "wrucqwygicww", "cqfmiwmxrxcxc", "dyhdsaaxf", "wfxrrgcfcsamyc", "saai", "mrxmuscs", "quqq", "whrqmyhwhhy", "wxg", "ymhmmdqcfggw", "uh", "m", "xrqfdwyyir", "uwdiaqdffy", "msmurugccxrw", "xiyqhmuw", "ffccsymrsmuqir", "ggsmu", "yycamfyc", "xw", "dqhiricmdrax", "uuyaqqsxwyywyq", "midmdid", "fqg", "dxfuyxgaudagac", "ywfaxgy", "idrwyhiaisrg", "sfx", "diwgacyauhwq", "xymar", "xgamry", "rcwghyafmssgc"]	["hq", "usgwarqah", "cyqfsr", "duxduxcchiq"]	TODO
zzzzzzzzzzzzzzzzzzzzzzzzzzzzzzzzzzzzzzzzzzzzzzzzzzzzzzzzzzzzzzzzzzzzzzzzzzzezzezzzzzzzzzzzzzzzzzzzzzzzzzzzzzzzzzzzzzzzzzzzzzzzzzzzzzzzzzzzzzzzzzzzzzzzz	["zz", "zzzzzz", "zzzzzzzzzz", "zzzzzzz", "zzz", "zzzzzzzz", "zzzzzzzzz", "zzzz", "ez", "zzzzz"]	[]	TODO
bbbbbbb	["b", "bbbb", "bb"]	["b", "bb", "bbbb"]	TODO
pxxmpqxmpmqxmmqppqqqqmqpqpqmqm	["qqmq", "pxmq", "mqpp", "xx", "p", "xqxxx", "mpx", "mmpx", "qp", "q", "ppxx", "mpxp", "mmxq", "mmpmm", "xpxq", "mmm", "pmp", "qqmp", "qpqxm", "xmxmq", "xmp", "pq", "xp", "mpqx", "mpxq", "pqm", "qq", "mqx", "xpx", "xqmq", "xqmqq", "qx", "mqm", "m", "qxm", "xmxpm", "xmx", "pm", "pxm", "ppp", "mpmq", "pqpp", "xm", "qmp", "mm", "pxx", "ppm", "pp", "xpq", "qpqp"]	["pxx", "m", "p", "qxm", "pm", "qxm", "mqpp", "qq", "qqmq", "pq", "pq", "mqm"]	TODO
rrrrrrrrrrrrrrrrrrrrrrrrrrrrrrrrrrrrrrrrrrrrrrrrrrrrrrrrrrrrrrrrrrrrrrrrrrrrrrrrrrrrrrrrrrrrrrrrrrrrrrrrrrrrrrrrrrrrrrrrrrrrrrrrrrrrrrrrrrrrrrrrrrrrrrere	["er", "r", "rr"]	[]	TODO
hzssimrzmmwhlnwyvsypwmrsmzpsybvwrllmvnzzpyfrnbpsmsfwdwmshdpbsrbiymviwmivdzbvldvbvllpzwydyvvmsviymfffsshshwdwfynzldbwpfsdfnbyirpdzbyszhpifhnvzizsmpbsrrvzfylfzbylimlzmrsbft	["nmvivm", "hyyhydynlfiim", "hzrsfrlvwpsrl", "rymnwlsnz", "ryvyzryihbw", "nlmhivnblyyhz", "sdvllinhr", "lrizns", "biyzbpsvsn", "hyszsyfysyipnwi", "hmpfirilwrvi", "ihzsddi", "mplnynwlhn", "ww", "yshm", "zfpfisvldpn", "wsrddfrwin", "dyrzzfsbsrlld", "dhvhhsbdnbrm", "prbnnzvypvpy", "lvysisbbnlrbn", "lbzhbwihlizmz", "vnzfrylmyfd", "sfnzrn", "snbnpb", "ffyhmliidp", "hhmmvmn", "dwzdbpmmwfrl", "vpdpfzzypdvpb", "dyp", "swhifni", "wvsinyswbzwwz", "dr", "lni", "ywfiynrinwy", "miwnzphrs", "wfpnpyblwnhr", "bb", "hswpwfsiyilfvb", "vlvywpfmwbldvzs", "nsmby", "iw", "pdd", "wwlwvwplvvfsmdl", "lfp", "mimvlh", "yzdvnizwwzwbb", "bfnmizbrnfzimh", "sym", "nshpfhns", "rzhssrwsvbb", "zrld", "wpprdhrnp", "ywmplinw", "bvllpzwydyv", "mlishviyhibrm", "nbpsmsf", "dhdbpbrwbivvs", "wiphsrfwvbzlsdz", "phhylbmfwszr", "mbmwwnhwww", "lznrhw", "f", "ymfff", "hphfs", "zsmpb", "dys", "svs", "vmfyynyllsfiy", "dvrb", "nndfy", "nydsyzsrdsv", "fpmp", "zvyfvlfpdhbmz", "yidvrvdfywfs", "shyflrzpnymy", "nvhdvrrn", "libsbrwddnvmii", "pblhmlmlshfdz", "fyrnbprdszz", "llzsfbyhmvfd", "hr", "bf", "mnwbmywmvm", "insvdiy", "nziprsrslh", "zyshnsrivmblrw", "filw", "llzfysn", "yyzbbswl", "iv", "iyr", "ssllfyb", "mlylbdhrilhf", "riprpi", "hl", "sizpnblsmp", "lzff", "rbzri", "hbzfhydwlzdzzhl", "nhzsdffsn", "hzbpnriyznipbbn", "vdhbrbsnlnrrp", "ivzmdv", "nn", "rmwbpifz", "lwmnhvdli", "psfd", "fpmzs", "ndsmfdvdsw", "vpswfvbnwrfmdfb", "simnbhd", "mrssfzymiwn", "dzbznip", "lmnfnzmlbwnhfv", "ldpbdnis", "lrzndblmbfi", "brlwpfls", "pz", "rpbimbdphnf", "yi", "zvbvnzl", "zwfzbynzr", "fplbypnizli", "yysh", "ffwbsplpdzim", "ynymrz", "innvlffvy", "pzs", "pvvnwrdvl", "ii", "zfy", "bdv", "yihzfvvm", "wdyvfv", "vrwpdvdy", "nwbn", "szfvfryrinwrb", "yhyilslmsdbpddr", "inrfpbrlfybfz", "nvhfpwbwliywmn", "bfihdvziryypbi", "snsvysfirly", "fdm", "ivdzbvldv", "zmbsiisfdnnmyl", "lfnrzpn", "mrydyiwsvlsl", "sshshwdw", "bsrwd", "rs", "fhv", "mbzyd", "wymdpyr", "fsrhwl", "phrvlbvirydbnsd", "nivmndn", "yhywd", "lvm", "rvvlvnl", "hiwwld", "ylfwrwbbsfpd", "rpvdsh", "shlflfiipl", "bhwz", "sfnlsrwzmymbmz", "nfrizmzmmisr", "lihzmlpdvm", "ywn", "zpnlminisfyymmf", "ibi", "zpbvpr", "smlympwlsnmyfpi", "fwdbzyzwrn", "iwzmp", "rfbbryzsw", "wzvmz", "zimshbhsizblmmv", "rbfw", "yirwvwdl", "hsblzwdbd", "ysvrfdfnvmds", "mlzmrsbf", "yzbpmpvddl", "vdysbsmbv", "vyhbhiniv", "rdsf", "yhzyvbdfpyrbviy", "zyh", "ppbbymylbwrl", "silsddpydw", "ybyns", "rwnzilfrhzvr", "vrll", "ylnlwvf", "zvzih", "lprfspbn", "dpymfn", "wswrdymz", "dhppzzybwllfyr", "rsl", "nnlp", "smwmhfz", "rdzibdhynw", "pzidrlhrnrmy", "hfif", "rwziwlsivhpbdr", "r", "biryblhmfbsh", "blsipmbrfzv", "mf", "vhyyfyl", "yimbnispfph", "ymss", "rbs", "hlnlvbfd", "szrd", "hfnnswhvwff", "vnmrfnsrshvmlpz", "bfwi", "wvfpbnynssrniyr", "yrrpsplrhih", "swpii", "lwvdnhsbpl", "smvwdlsbdy", "zilybhnpsmlppb", "nnffpvhsi", "niynznfrwvph", "sblnwfyv", "vdilh", "fnylhplhvwb", "dmyhiyhzdlv", "p", "ppdlzpvyiwibnw", "ihmhps", "vbhihvdpswy", "rvnbpml", "pmzzmdbsfiy", "wdffbvhfrfmpzhf", "vwm", "hmbbivbw", "bpnhnlmvhdwllvd", "ydzypbnflmyfnsm", "zvwpmzvdnbmfn", "nplfrimiwrh", "szhwrdiwz", "lrzvp", "dzdhynlwlvrlp", "dpzyhnidprmfz", "sirzrlffwinzrmz", "lfhydpllrb", "rhzhdhzyizvl", "fnllwrbiiny", "svhwmmfl", "ddrvrnfli", "mmvmpfzdwziwwl", "rsimvbwdzzdnz", "hdvssf", "zvsmdvlzldnwldy", "v", "dwb", "fhybm", "vzfsimfsidwb", "wimphs", "rrmybzi", "vhilvh", "siwnniwrhll", "rbbwbshmhls", "fnmmfliislvbi", "ywrhffsmfrlpynl", "vys", "bwnwfvr", "wfbypzrdlp", "pizrrziwdy", "h", "svrlhwfmrss", "vszpplsm", "nbmdzwbddnwfmzp", "zbpbzsy", "yl", "mllyvp", "nibmllwszibih", "hs", "wwmpwhdvbzbwm", "virnsivbpm", "fypbbrlhbfyphrd", "splhzlbbm", "ysimwvifi", "bmvnmbvznffi", "bbpywlphzsnznfv", "wdpnbfwprvi", "ypy", "yppmvymlhmisz", "fddsppspwpyvns", "vvslyblzbnvwmw", "fnbiizll", "nznbmbsildliwhp", "finnzdbbfl", "vnmbwwfzdn", "brzspnvd", "rvlnwl", "wr", "priwbffzmpvyn", "yd", "fzvlrrpv", "lswbiwvzzmndfi", "zmlsnbvwppn", "dwpfdiybmb", "n", "ivmhf", "ypbynlp", "yyddhzhlf", "vdnniilwnf", "rm", "pmrinfrh", "ir", "wnvlnyydvvyvlbn", "pfdvli", "hysfl", "y", "yllmddpwmpilmnb", "pdfhwbv", "bnzlrpfv", "vnfs", "sz", "dswpzdvrlv", "di", "viirnwifsdi", "ddrlfddlrizy", "z", "nhvwmyd", "nvfbrifrsrz", "b", "bbbfvnindsp", "vsvrlpbpyrmvmiz", "ilrymplnlszzzv", "brnhsdwlsw", "rvinrmbyvmsm", "zrnbllbzdpwrpi", "rii", "nwvphwvnibldnl", "dvylpbz", "iwwim", "pzrdfszvp", "mvhdzf", "l", "wmiyppffnfvyph", "mdbzbnizmp", "pllzvzdri", "rmrfzdi", "ilfi", "ybnrhpszl", "dzfrsrv", "vydhwbvfshzhdr", "hiilmbisdyvsn", "vbw", "vnhsz", "sspnddiwbhfdy", "pfsdfnbyir", "nvdmvwddhsws", "hyplypmsh", "yp", "imb", "mlryvriznvizmm", "ppsllssbdr", "hfpzzddyhv", "rlsfpwbp", "lvlhhvdvvdsl", "rdvysnbydpi", "nzldbw", "zihzmnmswf", "fvzpfzfrylrppvz", "dmmm", "wywsvlbhsrvhpd", "ffzfhzmpyyw", "nfnydhidh", "nymh", "rispslbisw", "imishwlvnyzrpn", "hbnr", "ypbfrif", "ipmrflhshifblbb", "rswzrnrnpvy", "sysrynszfr", "riplppz", "rdrilllzshry", "byvshhb", "ihbdvrzvyhnnimw", "rnmifrvwswfw", "vhvwbdbmsfh", "ynzsfsspdldv", "yrppyivd", "pzyypydylwh", "fwwbdbhmzwdw", "whiyrnfirwsd", "iwfdldvpbim", "hvlsyidnlmini", "hmsivrbvvsvysvs", "yyhbin", "dndslfsflzm", "msrm", "lsfblbndy", "nzzpyfr", "vbzysrnyhfvpvhv", "vbis", "wrvilmdlilzwpz", "lyizmfhypiys", "bwwdiszwfh", "fryz", "ifmzymwz", "lffdshz", "mlhs", "lmsdnbzfhpnlv", "slwlp", "vynidbypmzzsyzs", "wwzfin", "ywlvlivlm", "lzmdirhrz", "bihmfslbrnyhv", "sdznhnyswrpb", "rhswyhbrd", "lnbys", "fsrd", "mhyviwnrh", "ynymndszpnp", "pblynvbwzifypw", "ssiyffdmrnp", "zi", "wiv", "srrvz", "lfzbyli", "rpnsbzm", "vwidnnybmliwif", "pbrhmihwidmp", "dlsm", "vprfbhbymrywz", "vbblhvpzzfynm", "wylibsdnby", "flhzzmzwdwnp", "zyzmniidrvdhb", "wmnsw", "hrpmdnmr", "whnn", "s", "srylyvwy", "bynlnmsdrwzbm", "pdzlyprspdmr", "hzssim", "ifwzspnzwvp", "vdwvvdndrlw", "bzmmrvvpvzhw", "pvn", "nnlyr", "hfyfrmr", "pyzmilhwizhlhsn", "br", "vmdvwbv", "zvizb", "hwmhrhsfzrdvm", "nvwyl", "rvbizzsmsdsn", "pyz", "dhs", "vnlmwnpiysymh", "swrlbb", "lvnpfrymv", "nprfpb", "wmwvp", "ybmvznyzbnwms", "dfd", "rbnbp", "ynspsrdsnfln", "i", "hrzsblyzlphplnn", "fmz", "bvmnbbrhymn", "ibsvinhpsbysmi", "ppbm", "ypbrvhwvhwrwim", "vnlbb", "mplypb", "riirfdvyplws", "mnpvvr", "slviziybdiprzy", "bvhnnynlin", "ibsnymbifmln", "ynb", "nwyvsypwmrsmzps", "sbnzlblwndlrdlr", "ilwdmsbs", "znrwhdssivlhw", "mzwslbnpsyis", "nppdvmd", "srfzsshbswhb", "szvzzdir", "pfhyihbvziwh", "yhffbbd", "lrlwrvhnylibw", "rhdiyssbhyvbm", "ybvwrllmv", "zfdpnd", "lrsnmfvbsvrhys", "vh", "bwsnlinrhvdyi", "zfrmdslwnlrp", "bpffdsf", "nddwnsl", "mnmvhzzddyz", "fvffzdwp", "dminrhlm", "lsrf", "iiwy", "vwvsnbwz", "irydwrvrp", "rrd", "pppls", "zyybsswvm", "wizbyyihmlwywf", "vrdlyvhvvbb", "vlnybyyrmb", "nmrvswpl", "pmmpys", "rybsplfpwv", "rypvhsnpnp", "lfzfsvinmrlnfrl", "ryzirlzh", "biymviwm", "ivzzw", "vmsvi", "ppnsr", "nypnswhbspirhff", "hzs", "vnvdlrmbmf", "ynr", "srswzyv", "msyibhrdspbfi", "fzsbwfllhv", "hmzhi", "ppmnblv", "fy", "mhlivdsiffssr", "wrbirldhmhm", "fvph", "wszmpmhlibnvhwi", "pzddyp", "mnimfiinzhwyhfs", "w", "rhyvlwzhm", "bwnbpb", "fryvwvdvhms", "ib", "iid", "pdzbyszhpifhnvz", "nbpfpbd", "dz", "mffiyfyzsrnw", "nnwnyvmzriy", "wdwmshdpbsr", "vpirnvbpzlf", "yz", "rwmsvp", "zb", "ywvnpiymippf", "irwzyrlidszbn", "vmvfslbwnbsdrr", "lsmwlrzpssyi", "zsvhfvlzibwyzbd", "nyyzsf", "vsdlmvbdhf", "dvnymn", "rvympwimbdmvl", "vwbbzbrdh", "dmvpmzbpnbhbvn", "irwzl", "hpwnvsp", "slrhr", "pmpbbbfy", "vmnidif", "frmybf", "snph", "hbfvbdrbbidw", "sypbyvlpzn", "fwzymyyn", "hlinfvli", "npbrpyilvfiwdp", "dvpzifib", "lvlmw", "rvin", "nwvfppbi", "nlmsyfifyfirh", "szzddvbvvy", "rlbi", "mrsmndhhhbdry", "vbrlfwbpmplh", "bdpynnrspbvpw", "mznzwpnlfm", "lbrvwilfyz", "nbnilsvnybpf", "sn", "swdlrdbbppsldw", "wzblvd", "bdsfvzhn", "ryyshmzr", "lrwldymswlnhwmz", "ysdzwnphzvwil", "lpsflnrl", "ldzyfyynvwszdwi", "yihhfyfmipb", "mnl", "nlrhnmwzmrz", "mdryflfsms", "hpmrrfdh", "inmyybmdfhzwwy", "yhisvlwlsbsz", "hnrlsfnwnd", "zhfsvm", "wfpynmb", "nbvfbfnhbhy", "zmrl", "ydlpshrfyhf", "rzmmw", "swviwzsh", "iphyhfwimyiwrnb", "bdnbrvyywlwfpy", "sdmfzhvdwimwsrf", "bblyvlphdwvinsh", "myidplypdwfbi", "hbdfmsfmmy", "iz", "ywvvh", "hyydnnspmlzpnd", "vwhwrvfy", "phffbsildmswr", "mfyzrhd", "mwbvhf", "yydbwzrlrhb", "nmphdpphpy", "vmr", "mfsnn", "m", "yh", "dhdfhnyidrvppvw", "snphhsvhyvv", "hwhfsd", "sbyhpwmvswhsdl", "pmnbzzvdvmsrhl", "fnlwzbbbibn", "rf", "ypzhwrvbdd", "ybvwdwblr"]	[]	TODO
nnnnnnn	["nn", "nnnn"]	[]	TODO
ttttttttttttttttttttttttttttttttttttttttttttttttttttttttttttttttttttttttttttttttttttttttttttttttttttttttttttttttttttttttttttttttttttttttttttttttttttttz	["zt", "t", "tt"]	[]	TODO
acfcscfacfa	["csa", "fa", "acf", "acfc", "scac"]	[]	TODO
ttvtttctvc	["tt", "cc", "cv", "vt", "tc", "ct", "vv", "tv"]	[]	TODO
wdgmdtaafu	["wdgm", "mdta", "afu", "dta", "wdg"]	["wdg", "mdta", "afu"]	TODO
nakm	["nak", "km", "n", "a"]	["n", "a", "km"]	TODO
cxcccccpppgpxxxgxgccgxgxxcxpxxxcppppxgccccccgp	["xc", "xxg", "x", "cx", "cppxgpg", "p", "pc", "cgx", "xpgpxcg", "cppxpgc", "cc", "gxxpppx", "cgpxcgp", "ccggx", "pcxp", "pxcgp", "pgpp", "gxpg", "g", "cp", "gxxcgg", "ccccc", "gxxcx", "cxpxxg", "xxc", "ppxc", "ppppxgc", "xpx", "pcxpxgg", "xxxgxgc", "pcxpxp", "cxpc", "gpgcpgp", "cxpp", "c", "cppp", "xxgx", "gcgcccg", "gp", "xpgccc", "pgx", "xgpcp", "ppgcp", "pcgp", "xxpgpx", "cpg", "ggcgpcg", "xpxxcxg", "gxc", "pxp"]	["cx", "cc", "cc", "cppp", "gp", "xxxgxgc", "cgx", "g", "xxc", "xpx", "xxc", "ppppxgc", "ccccc", "gp"]	TODO
rrrrrrrr	["r", "rrrr", "rr"]	["rrrr", "rrrr"]	TODO
nnnnnnnnnnnnnnnnnnnnnnnnnnnnnnnnnnnnnnnnnnnnnnnnnnnnnnnnnnnnnnnnnnnnnnnnnnnnnnnnnnnnnnnnnnnnnnnnnnnnnnnnnnnnnnnnnnnnnnnnnnnnnnnnnnnnnnnnnnnnnnnnnnnnnnz	["nn", "nnnnnnnnnn", "nnnnnn", "n", "nnnnnnn", "nnnnn", "nnnnnnnn", "nnnnnnnnn", "nnn", "nnnn"]	[]	TODO
sfftvfiv	["fvsz", "fvsje", "sfftv"]	[]	TODO
vk	["v", "k"]	["v", "k"]	TODO
jojddqdsfbcjojddqdsfbcbsalcjooamztqmcof	["zocit", "qfcfj", "ydjaq", "ydbcbmaqmfqszdmjm", "stcimsbfctdllmofy", "sfttslbzjzjllcm", "bsisddlazztoyzz", "zizzz", "cflqcoiqbldbiz", "filtolf", "sqm", "zaymjdlfdosms", "lcsjltaimy", "dbyljclz", "qqyftsjljm", "lib", "fslmz", "cyd", "jzbqfajocsbjm", "smtzazb", "tqysfjz", "tysdqfql", "aymiajzdymjtl", "oibcqcjoq", "bstfzdiitsj", "ilmojyjlmssodo", "dmqf", "mmalfjqyqzsjao", "jtdyyiqotc", "yjtqjbqqqqa", "qoqqsb", "yyz", "stbayoj", "dymdjtcliqallffsq", "atjsazsfjl", "tfotitibdtojbt", "bdjal", "dtmtqibyfamodstl", "famzjfmsoy", "mfsmzzamtzbl", "iqqd", "qdb", "yiscdsc", "ifbmoqdtb", "iaozblay", "cdfbl", "sczac", "siffyyb", "qqdjzflfs", "tcfazatot", "yol", "dsbztsazsdlobjy", "itiajjjqmqcqsq", "dcjzf", "bomqbt", "llycdcccjofc", "bbji", "qtmbzjyzjtllc", "fyjasq", "yimqoido", "lodb", "abjdyttsoabdibm", "tbjlfdco", "zbbclattmjl", "jsotbdtcmf", "dtadtqqzyomys", "abajysoi", "tbmljsfdcs", "com", "sztofj", "aiyz", "cibcjbjfstdcqj", "jdqmofzibii", "ofcszlooyfzsqcocb", "jyby", "fcqb", "scbdjfala", "dtm", "tmtyttojj", "stafalcymoitoa", "jccqzlyljqobz", "yzasaycclcfodaf", "yboqqibfootqda", "iljdyczqoqztiz", "fojmsmzofjala", "jim", "bcqcsoacmz", "idilczcttqtq", "ojyqddtofdb", "jlsstf", "ilqtoli", "oiizs", "stlsmd", "cbziyjisobytjdiz", "talqdcssjbmi", "szcfbzsm", "mtdmzlfoczlya", "bam", "bjtotdflab", "bda", "tddidybsfmoac", "lstfbq", "bscf", "odaojydc", "mydlqf", "ofll", "dbjsis", "ldoydq", "omoaa", "jlmozysoazdc", "jayloit", "fmitbdflm", "aomzoqtiqymobbyd", "dzzicyzyfostytyco", "yyoftttlzqaqzcot", "odfidi", "fmqbjyfzaymsqqf", "zbtcqfocjqlm", "idmljji", "qmstssizototcd", "qcitciqttfqlcttcf", "scfaoszdo", "olqsiylztoq", "slojqyd", "fqtjazftf", "falijbto", "oobltzdaozdta", "fizaoabolodlfdaa", "dsstbziaad", "osmdfdyyjljz", "lqlilb", "dsyyylslzbiisjby", "mydasmqyoia", "qfzfqqocytoosftc", "mztoctzomdbda", "dsjls", "mmcotifoi", "qacqodjb", "imiftzsdjqtjb", "iyyl", "liymcj", "cflbotfallzzq", "ssmz", "ityqtcasacm", "tobsqofa", "jmbtmiitzadqmadqm", "qys", "zdfmmjjfsdmb", "fzddijjybltzmyctb", "slzjdlssq", "ado", "qjld", "oojmqlqa", "fqojcdzzqooomda", "qfczj", "ytzs", "sazfijctbdazijjq", "yqoslqicijljzsfij", "ljstqfbo", "loatboojc", "smqqqosizcmtb", "bzztbdmqtccotjibt", "zzqji", "icofsajjfcofiifsi", "yjiyqysbdasl", "dlfdtactds", "tiqmobcobjtasscay", "mlzltaj", "jlbfztbfzoyldl", "djbmtlmizy", "tzssddz", "dyqyfijo", "cyystzydjtaqst", "qsocsdjyftyzfafq", "cojzqzffytbo", "sfmfcoalqbtsifdaq", "iaqicfy", "qyfosayfb", "syiiiiyqqa", "iyjjzmlj", "fzyodicjdfz", "mdsttda", "fsmoqmioddijaai", "cyssdcqyjtbfy", "lcqsildyqyjc", "bcsqqdyzcdzz", "ydfyijdbitfzysl", "jlqddt", "fqfjbjmiliosfycq", "flociooobimtf", "mlctojyo", "dyt", "fdbmjqyys", "qiczqbaqsba", "yzqoaodff", "lbfcob", "cjicomlsmtmd", "yaoysbaqsflcbljzj", "csjbbyttlqcbozmo", "aqtcbfmo", "qdczbtlly", "csbbjz", "qaqmzjimfyjbc", "lsomodqzbcmy", "cfcod", "qzlzla", "otozjydzi", "mbjssymisi", "zlfiooja", "dssdy", "ociafsoicjsa", "byaf", "tdo", "jqyjtbmtmlstmoty", "imbijlsyayzbcblds", "tbilyyzq", "bmymq", "bzqyamyo", "alyt", "bttctqsa", "oimzoaatmtqlydls", "oyimfjmjat", "dyafjs", "aymtdylz", "djmfaszfi", "llftbqltmiiflqmb", "yjjtcyljao", "dqtctlzbltbl", "bzaq", "fdofolfdacioybts", "zolafztfaiqfd", "oizjmdizdfbtdtoc", "ftaiajbl", "dyftddatzcm", "qdibsdlbmzjal", "ocojjydqcjqztt", "jdqzb", "zabdqlzdooqjtqa", "cqlzocacmzcjqdqt", "tzcaijydjmbs", "isqmboctm", "cbmfabma", "qitmjzdsalbjf", "aic", "clbzoatcdmmsazq", "mqosmy", "zyliys", "stzlmmbdbdizcltj", "lmaqb", "lstljddcoyabtmzq", "obqd", "zyftboifidfcflbd", "coqaliazs", "mlqzbsmolooaoi", "oiqolafbtd", "foztytcl", "sjbiocdqjzyj", "qtfacbdqzoz", "ztjmoyi", "flzqjjof", "tyaistotayzcybm", "tybsiaomdyqabmo", "mcctfoia", "jbtadaqofldbylt", "djizqosjjffofbfj", "socjjcojcaiz", "qbyioamocdcddy", "ajlctbtyb", "tda", "cqdcdsysjf", "jlcamzmcojmzjby", "mjyjs", "jbo", "mzddjiisbjyazftfb", "ifo", "jjojyfccslczsdoa", "tjqlllcbaalmj", "ioyilbytdmoqics", "fidlzqafqjcj", "yco", "tzyo", "ffatqtddilflm", "mdclbtlsq", "cctimqjztqzqffmd", "jzm", "cjmjaf", "sltddddylsdm", "mycczaof", "jdtdmildcommiysb", "fflbi", "bjizodybccajqsf", "ybisajil", "aiq", "ffif", "tqqmfdjamdm", "mcof", "lbdaqdiqd", "lbzcoylydzcjzjqq", "accbyqdbydfdbqb", "zjiczysfb", "ibii", "lsbtdbyisydyc", "fomzfsqcqdzbmmc", "sioyatdqajdqffocl", "zsffm", "mcdostydlccios", "mjycbqmmllll", "ajsd", "smclzodysz", "yytlsald", "bsalcjooamztq", "mtyszdtlclztyjjst", "csoytl", "jbbflimsasj", "qyafaitisys", "ysscdyysi", "dqlqmazjtlzzjb", "lcmzlcqqbfqmjtb", "tldyamcyyyyzmoo", "zjqaffzlidotlyab", "ayzoziyylyfaa", "balbjo", "idjdslbqabiaq", "fzfzoctzjfsyi", "sfjmzttaddlsqyo", "sczzmja", "qilbbotqzzzlj", "aictiztfaa", "syslitjojbj", "ofjdybjyjjcfsb", "sldafbljicmcbqoi", "yzl", "fdsjdtibacc", "sjoaqtzbiso", "cfs", "lstiolc", "tosibjqzdaod", "qaofsmtbbz", "dfiziqaa", "ymdoomb", "flmi", "omblybi", "jllbiljbszdzotfmy", "mlqyyc", "taacicylsbaio", "szstd", "ajtiyttb", "ltobcm", "izsfbd", "oialbascllmjq", "cissdyfzysccsaol", "omcyoi", "smzb", "falamttmscs", "tlqcijydodtt", "aaltomamoftjdjdm", "dbqyljmm", "lctj", "tjiscmqotfl", "oqso", "yozaafdsjazacydoa", "mbbtqsflsiiydcyqm", "mijsysfobsotysqfa", "mjotdddylbctcdmdt", "qmlqbfymoyfi", "jtzif", "zmfitf", "abliqd", "odbycdtlji", "zqz", "jojddqdsfbc", "dizmldzamccyfdd", "zifdiyytltqb", "yidiqfo", "bjb", "cmmscccjsm", "olaozdjottdoqq", "bjayylqfizcjzbcqs", "ttdsoofszzyoa", "dacjoclfsqbbztat", "tyfqf", "bcotqcfobbc", "cly", "fmoimq", "ibsmjqyqsyf", "ldq", "fcsobqdqjjczmjja", "qqmmzmbjbsbjcbi", "ljtqsfm", "tfbqqjcydjdjobc", "osfaljbbmbbtai", "tjaofdzacdstsqb", "mycjttslszfqjd", "ljamybdaoyfbmto", "tmdtobtd", "iffjybbocatamb", "cbcstbm", "mcafidy", "mdfaljymybbacdcqq", "zqaj", "alqsaqdq", "qszibfoaf", "abcqscdyf", "lfaytsiolo", "ojmyctbqjyjafojdm", "ytdlzo", "bosqcasjttaz", "clltdsscbal", "dtzs", "iizybjjiz", "dss", "sdfo", "stcoofoblibcf", "iibfzyjjdaajsbscd", "csmfitlajidfldci", "jmyoddiqcystim", "tidyobjzysat", "qyiiaqfqbsllzqdm", "abfjaibaqdyoaqyj", "ldydbsjmidlcjjc", "jyozcaqclcfciqsjo", "bzzliqcmliosaj", "dmzo", "ymatjojfalctiyif", "tmyfbssty", "bfjztdaqmqob", "cmsdastyiimsizm", "lcflatfadf", "miimloclcz", "zyctysjossltjyi", "jooztqyajltmc", "caqmlsdzdl", "mjldbzij", "qilsdfjzibqccsfi", "acimm", "ymmlofosalfoj", "dlylfiy", "cmaifibfitz", "tdfzdjsqsqatl", "jfafjbtitzods", "mcsozmcssaybsb", "zfct", "qifftcb", "qdmmitomjiizim", "itcfbf", "omllq", "ydl", "itocjcflozqt", "zfzcatzmoq", "afdbmszymy", "jcq", "bbqzqbdamyo", "jdbaiqyd", "mcmfmjt", "qjyzttztizz", "sloasytqo", "lcl", "ofzyo", "mlio", "qzzs", "tyoaafbmlcqjmqtzb", "mfl", "ibzyfdymaoqyolfy", "fqzlbjsj", "dlzsdybboqz", "stsfff", "zcosojatyolsffmbm", "sltqytifdffmydsl", "ojfiytd", "tctzqo", "ojtyzoqicfoszm", "lsbmmjyiaizodbtly", "molimcdbsibtys", "yyjbzcliymd", "qsddoctsdafzcdz", "mqoqbjssfmfo", "ilml", "fzoqtttt", "fjzjbmbmjt", "sodzsa", "mstyybjdtctojdbla", "dicq", "tyqmzbyfqjjfdliz", "lofbat", "bbcysdyoac", "adjijtqjyq", "cmazoataoalcl", "fysiistcmcdy", "mllayfbofamizf", "tmstljszfdill", "iocijatbtqbdcb", "maqmmsm", "icfbzlyjj", "mibqsma", "lqcfabszfbzdsy", "tscy", "zob", "oadscqc", "atlzsadm", "tzla", "yoyjz", "qca", "bfqbclsaicomlmyta", "lsz", "atmcj", "bzsmjiqlfy", "istfdm", "iayt", "jiymzimmdfozci", "tzbstiaooiz", "qjojb", "bcoczdilslsoqzyzl", "cjcllqllz", "sdfcdsamocjf", "fdf", "mztiijfbfs", "ljjcfcy", "ycbclqmsjjamjtt", "mizdobitdajlimsqd", "bbditf", "btyolotqmjtac", "djstbytcjly", "cmfqstimiq", "oqiaqqzycmidsbmya", "ytbfts", "idyolbizya", "qdzsaolld", "ssqboqlcyyil", "tfjziy", "jmiosjqmbotsdmy", "zfoyilylybjl", "btttm", "jmimqclbdsym", "qfaq", "tjztztmotcqfbtti", "ijiozjzjmt", "aycqodbaf", "qftom", "aoatodfm", "iybtisoatmiiqdt", "cqdccyicbijms", "mloazqtl", "qqis", "jqoyftt", "bzt", "fslazqsfzsb", "lmlm", "yifmjiaff", "qltbqcjqyifssyqz", "ibzacsbqjd", "fajqjcltzyzoaiqd", "liolz", "szobfqqiycciy", "cmaaiibyofafs", "amyiyijqtbqyaz", "yotcdbmay", "yqtcymqci", "ldadmbc", "ofsbf", "sjqtizyyjlta", "qdfsi", "afcjclyzdddb", "ftabibdsz", "ocqz", "losiqaiofmjttdyt", "djsjdd", "ilaqsiyjyfbd", "ttmtssczai", "mtsqfdfflmdsqqm", "mmqqbcfmbaftd", "bimcby", "ajysdmmbdajmllslm", "mboc", "jdbs", "tomodyobcsqa", "taotisjiiqdty", "jtdjl", "mczbfiaijfol", "bqy", "qcyojy", "dtqy", "mdotmytljjcttammd", "ymql", "jjcjzoooq", "cqf", "sqqjafyoazdcc", "qsliztlac", "yqooitom", "ilsmfqdmljs", "zdlbcifob", "lyzqtziyilzi", "dtsddjz", "bysyoisadtmo", "ciaomtozfqticodo", "qydzz", "dmlyzdymf", "iqj", "cmqbitqlyb", "bzjdjbtsoffddcl", "jyayflyfjzoytfjqo", "lfjcioaqascmay", "bqtflcosaaia", "obtamdiilzyomq", "sbozbtdqmqbtfibyi", "sddzmzyjlolzmd", "fba", "sbzaiadtbqjdzbcfb", "bcyzzcdj", "sltcqqt", "lslslsbfaasc", "smbcsfosmfysdl", "scabmblijy", "ltolfillzozjyzbdl", "mslszdyzotiltj", "dbyyloytdajz", "istoiymzmaljdomts", "czjl", "sffdlsczlzd", "fyabacbqtmd", "csdyctmqiiqqbflcf", "tjbtm", "sfbtoqazy", "accjftld", "amjdsjcmbfam", "jdzofojsifo", "zllastyzy", "moyditmfoota", "odltojyfdfmzdbzd", "jydoia", "itiz", "sjctmqosydlqaq", "ccdqcftqaft", "jboblzlibiqilc", "ocjcama", "lmsobolafazdqaoaq", "tadzjm", "fidqzmj", "yfstjz", "ialcbqdllqbtii", "yib", "tqoqbqdzta", "zcdjyilmddtjdzzf", "ytqctcctmszo", "objsma", "aoaycz", "sazqbi", "alsolodamzyiszzm", "ajfqq", "blmyb", "fmsjcf"]	["jojddqdsfbc", "jojddqdsfbc", "bsalcjooamztq", "mcof"]	TODO
q	[]	[]	TODO
ippcd	["pdiqr", "ippcd", "pdiy"]	["ippcd"]	TODO
sszz	["zs", "sz"]	[]	TODO
ss	["s", "b", "sss", "ssss"]	["s", "s"]	TODO
rrqrrr	["qr", "rr"]	["rr", "qr", "rr"]	TODO
lvwwncmmjnqvtqnvjntmmvnymvlwcvwmqtcmooqcajcb	["otwoibivqbl", "wvoviivaotv", "lymrcbq", "maymwrnrow", "javrcabmt", "lnticvo", "niro", "qncvywcrqcoi", "wovwnyacmjwyb", "aqqtraiyanbtq", "vrm", "mn", "inbviiiatt", "rrittaabmywo", "wbtlyqqwybiqi", "wnqjoraojcrbb", "mccbmomwaa", "vnolqowiojiqaav", "rwqal", "oi", "tba", "vqnjimrrnq", "bmabvvbqcc", "noiynbrbbavjq", "abtil", "jtcbbc", "qlcv", "lvwwncmmj", "oqarvjaw", "cmnma", "wyinlarcomiv", "bltqtmlacotqacb", "jcivt", "tjbmrqbjq", "rnoamvol", "tcwcy", "lwnvoit", "bvwqwjlrnoj", "rovcovwi", "lyqyjvrwiwot", "nt", "mlvmrrmiicqy", "nmyrjcc", "rljiyjtl", "ic", "rljoalqio", "omqjajqltlwvotq", "lwwnnyjyjcianyw", "jrbnlctiycia", "vvlvwyvor", "iqrtro", "lriiinjamacvvcr", "lncqjaiiayvw", "tyy", "bltranriliytni", "mitabqbmtnw", "niytci", "qvoyitionm", "mcratvjiawmb", "amty", "tj", "jqatnwomliomy", "wwwtvom", "tnwymoccvlbwyb", "jccnnaamqyortqv", "oot", "lq", "jqoomjqjwlwmyan", "arnmcqajmbl", "ootitttl", "qrowrjqtrlc", "lrir", "vcraovvbqmani", "yovnqjcyibjnnvj", "rby", "ncwnirryj", "vtjmmiwi", "iolttrovvmcavn", "mltcwrl", "tvnbjtibvoot", "niaytqvyawqq", "ijrvoiqwywrm", "lyvbvwbmwjqor", "cycqyotniwom", "mlwmaycyvtwbyo", "olwmy", "rocqm", "bwnn", "vwomnlmjyvajlo", "yilctwcbvj", "qi", "twinivyonnmt", "manq", "tyiabyaomlllrcb", "rrbia", "wblqtmivnrni", "yt", "nvinoj", "cirj", "qltbn", "qmlqbrcabma", "yvvwvqajyy", "aalmljajoj", "rtt", "vmbjco", "ovjmttam", "bvaiaiwtqml", "vaqji", "mlvcmj", "tjlvobtmj", "cww", "qnm", "atoqvonciavwi", "yn", "clb", "r", "wcbr", "ntl", "jnvtwqicya", "oqqioqvjvtq", "ibbrttqbab", "aamilrnnqonybn", "acmnjmvwbqlytl", "ano", "rqcjactynjryv", "iiibqywbwa", "jw", "yajclwjl", "olmaonnraoov", "mv", "trloc", "bnta", "oatln", "rcnbcb", "ymm", "lny", "qnrwjimaoivjn", "lyatww", "cjbwta", "mrnno", "mvltcctc", "qtojyclvvycrj", "twy", "tnavqov", "lojwcbwvyvicwrb", "ibwjbviilanc", "a", "ooqmit", "mvvnarnvvaoqin", "vojytwjcrtbmqn", "v", "jjbmojviwiiwic", "o", "mvlbo", "lnq", "lv", "wnmijjcjlbvcnj", "wqaaivotlcctqcj", "lmaorojacw", "nrtlvbyyaybw", "tmvlwtnr", "ilymaovrcbm", "oa", "noimqyyy", "ctwt", "vyorajim", "nynmyabrtj", "lloyyqtrinwwoov", "wqbcvwiab", "n", "qwtccanj", "anra", "mvlwcvw", "y", "yybnqtamcorrnb", "ljanmyanvjjccr", "roiowtayim", "lrqo", "nyqbblmjll", "nqvtqnvjntmmvny", "jwrblaavjiyort", "lmmytmajwjcqlr", "b", "yivnwbcna", "ybirwi", "ajtnlnrowqrmtli", "l", "tyylmlrrrwbj", "bnwlwtttcbi", "iwra", "qlyqiitqo", "vncmaclloqbv", "wwtbtlbvylb", "jaiwwwwo", "vwavwb", "qqbnjrraiwrtct", "rj", "avj", "ayvoymttml", "obbo", "nwlaovq", "ojncjovrtlq", "aqbmjy", "wmw", "blqqbla", "nmibaoncoytaqjj", "yitcj", "qttvi", "qmiaj", "qytqtwvatobjomr", "wm", "boa", "ojqmvmmrwt", "yowrcittvomj", "jwlwqy", "ywynyvwiowm", "ncrybr", "cvivmiiw", "yo", "micny", "t", "mrccbwr", "comjtratnynbnn", "cqyiroivaba", "qjirq", "vywri", "ivc", "lm", "mqtcmooqcajcb", "rlliqcymv", "rjwqootocil", "nyvcyrbrwbl", "ntiwym", "tiymqlvc", "qqojwbmrri", "otalmvomtnvrv", "iroo", "c", "larvvivrqw", "qnqailrjjaqmymt", "lcl", "jqcb", "acjqnibjivvmji", "bcbrncwyo", "oyqatt", "byiirra", "ojmvtnrim", "lwl", "q", "orctlyvvnnmv", "wo", "jbnjmyvmbrt", "tw", "ijrnc", "lr", "tyytlaatvbyqac", "yiyricarblaciv", "mwwvq", "mowittbmrjqy", "qyyclnqmwnnv", "i", "ayqwmtya", "qtabrnanic", "ciloioab", "ociictrvywoiiq", "ajnycqv", "jtjnaocqyirm", "mcll", "obqtvo", "qloqqycnqnc", "vonv", "nbviyibtccij", "mvijbtvbqrq", "rlrrivlm", "lqrvtyovjvj", "bljyqocotjj", "rtrwqcyj", "bcniqblawmjn", "vovivq", "intlqnn", "vyljqqili", "qyomra", "nwo", "rqwln", "brblyilnnqwqrji", "ryljvaqrwlmyrty", "jvnjj", "qbbbrrnymiaam", "nanwrbrawlty", "ja", "wtmavjctrlwqmr", "wmmqcritivtmowc", "oqowornctnon", "cimwm", "cjvtrqnoyjca", "toyricwiclbt", "cvtlt", "ttbjyiol", "bymly", "ajoljwwitw", "jcittlnjwqyilyo", "yryyblavtlbrwj", "qmtcbw", "yvbjboqic", "yowijo", "moo", "aamclnianncloqi", "rba", "bnqy", "lwbq", "mymmn", "wqojybir", "vla", "loobb", "vvjtmmb", "jmo", "bcmnvrqybybblrc", "wmnrybnrnql", "omc", "vcjw", "nijbaarllm", "qoyj", "ijwy", "arm", "qllwrbtji", "wobqqbonnwcyi", "btqnbywwjtctj", "qqlaltjiqwq", "bwntw", "jyovnt", "aoaloovtcwqimty", "wjqrjjcmwriamm", "lcvbajqnrii", "jo", "mvrwwnlrrr", "ajwwqbcmtwtor", "wb", "qlyibtacotvnri", "tmjorclonctlo", "ininibwjmnw", "wyyiqybjbiwy", "icrnat", "m", "blmrcrvy", "mtntlwrqv", "rlacjjictyr", "bjtwco", "mm", "wryb", "wv"]	["lvwwncmmj", "nqvtqnvjntmmvny", "mvlwcvw", "mqtcmooqcajcb"]	TODO
nbbdmbjm	["bmnt", "bmnzg", "nbbdm", "bjm"]	["nbbdm", "bjm"]	TODO
n	["b"]	[]	TODO
rhdhapgbaabiddaaaabyyyaybiidibalibypdylilgadhiygildygibpi	["lphdp", "ldarhhbhahygdlpbb", "gyrilbalyir", "byhayipbbblbaagyg", "dhdhgbhygrbrb", "hihggbraydblrydar", "grpara", "pldgghlyigagrdlybap", "aradp", "alibypd", "yiaiyigh", "algbpyhdrriabdpdlyd", "dpbggp", "dyyiiip", "aapihgldi", "raiyiybdyybhliyp", "rbraipagrdllrrpgh", "airlhdhlbgdbr", "ydgbghai", "ppgalhaigrrrbr", "yigbiprglirgba", "lahparahrilbaag", "lypgdprhppg", "irrayybyya", "ybygligiddrlyahyagp", "gyhpbdlryali", "aigglyl", "irhhip", "yadgyrhhi", "bgdphygd", "hrppr", "iigirygbhyrgrdall", "hhdyayiag", "iybby", "gylpgprl", "iryailyidbd", "hrralyp", "rpbbigrhliyh", "lbhdhhlyryiphpihr", "rayhpairaglll", "lilygrpgpra", "pdhhhryyprrl", "ggdghryihpy", "badpri", "hblbr", "hpaaggi", "prbddayag", "lpldhrbayibddidyhl", "ygildy", "hlblidpiib", "dbdphgphlapariig", "bhyydiddprlylhy", "ardaibaigpld", "ghpgbbryh", "yyylriyagylbhih", "bgrla", "ripgdrrbgib", "liyargladrairahppph", "lbgdrgihrrilb", "drygipyiphibrlghy", "gdrbdiiihaddhhlrha", "gpybaphpyryy", "hghryypgiprbpriyra", "bhydldpr", "yhgydpadrhlrlhliry", "dibhhidbrih", "rhygalarrig", "idbahpyprb", "idpbrppyya", "hilgpg", "pilhgahdirhypgradb", "ylghdliibli", "drahybayllappa", "hdhylbdagalbggiarad", "pbpilylppgrhhibli", "rhglalhrirrlra", "aylylldpdbdlhiyaha", "abypybalbiybph", "rlgirygplllidbprya", "gdlbhyyahylybbri", "hdrbpdyhibglrgrag", "hpdil", "gibagpdai", "dpibggihah", "bdribhgyp", "iggrphhgypyhiiidi", "yiapl", "alrdlhrb", "lddhalihbygbbdr", "iadldylbyiydiar", "gggdhprgdrahrhlgb", "hallybaglplhhhg", "aadiaiibyaaybg", "higgyihriihbppb", "rhrid", "pyrdgidgbilryi", "llgarpbllag", "yiippdldrirgyiyyy", "byraradblpbl", "braridyhdlhhyg", "hhahhilaibl", "rbplirhgbrbbpadhlyy", "bhihdrhla", "bdliagpiphiiibihg", "hhigihhgd", "dhadriddgh", "aghbi", "lplhddrd", "allaiahldihhyl", "iyglabhyrybyradrrb", "palgdydgbibghpli", "gllib", "ahdiiy", "abyigdrbldrgalpglai", "phlrbrlyi", "apbpydayahlrg", "ppbrlaarlbgabgpbypa", "ygbyhihhpblbapp", "iaayphlap", "ydhdbggyhipyipraal", "dbiiyiibrdbglg", "lapgp", "rlgrgdiy", "bhdabglrdahraygbhad", "ihggydlrylyidbyygp", "dirdibbhypp", "adadgapry", "aallylhhd", "daibypbbgglgrllghg", "arylygrdlalrdyp", "rpaabhrlb", "rdhahylr", "bhpbgbdiylahayadlb", "ypbiplriaigrda", "idlda", "hphrpgrbggy", "plgyhydiddri", "gbliy", "ipbpdygbalipgaaldbd", "dyllphbllribyil", "blbpialp", "pyadipbhii", "bbhybahb", "pdria", "blgiaylrbihgidila", "abppdbrdlpiig", "ypahglgairh", "hdailhy", "apiyablgid", "diydpagybp", "yraagpplgbrhpg", "hiiggb", "hliiyrihagdddahhpr", "iglighrhddpglbll", "pgbaab", "agiga", "iddaaaabyyyaybiidib", "bbigah", "gplbprrlb", "blygbbhpgyyddrh", "rhrpdgbd", "lgahlhyigldbgrhy", "ghrlgpdldbydpybahid", "lailhpy", "llrrdapllyhridba", "ygpdbgirgda", "yrdylyylya", "hrrrdb", "gplhrdhydyyhhb", "plpplbbhidprbbbbg", "pdggpabplyydpylba", "rilhpahipgrbiyrayrh", "ibblahgbplyhhdrryy", "gdaygilrhrhhybly", "gdaigadyaad", "ahalbiirlgghalddyl", "rpllblyplaygbdili", "rhhibpphrla", "iaihlghraapardlld", "hgllghgpdpggyaarrd", "alddldaghhgr", "hhlilaarirhibyllrrg", "ididilpdbygpid", "aihphpgb", "dpplyy", "ilblyhgadhhbaay", "gbaiyayigly", "rrpbidapglhabgy", "lhpbrgiry", "yrypdryihyh", "bpdrhhiggyl", "ailraddbyrgby", "biyrb", "pparigpdrarbgbl", "ldpraprbbalg", "hilayihdgaapllgahha", "lrrglylrbb", "drriar", "ihrdlp", "bbgaadaygr", "gbiddiblirdi", "phprgrplryhg", "ybadgdlglyrhap", "yiglgahbl", "giiybdpbrryiyg", "ybdrgyphdlbp", "piipal", "piddpyrlippa", "apybhlrrdahbhyaphla", "ihhdpyigpbapp", "hrprrrrybir", "dhiihhrrhp", "dalpddibrbggrp", "ydriblbadrpiarlpiy", "dirprdriibggaaypllg", "gyylliadbgpypiriiy", "arghhdpi", "apyphdyhpiyphdahap", "yphldrbbblhry", "aabyadbilargr", "aypri", "hgbhp", "hipgigypallirbdglh", "dpyphadaiyylypgypyl", "ylilgadhi", "abylggyiyyrhrgpadpl", "dalldpagh", "idaygbl", "iagiyd", "pyhhdaradhlay", "plgrhaypalbi", "ahpidhyagbpdbhglh", "dlbbbar", "aapby", "lgaryhiraarihbl", "bdpblhdlab", "byrll", "grlap", "iyhyli", "lhbpagahribibyirb", "ghhrgiabpyrlh", "rriddr", "hiigbyibilgdlbrgap", "apdbyrpl", "gibpi", "lhgphydibldbrihaygb", "aagaapyybbrbgb", "yyhpibialyigyyai", "rhiayryladagap", "bblpplpllrdygdigyh", "lgpdlappy", "iadlpgdyrb", "iiaaghrdrgpgg", "grhrppaahpidihgrpha", "apdid", "lbyriilyigyhyrrb", "yaphdabryydhbpa", "ypgrhpagadp", "hrhgylhygp", "yaariprgrphbirl", "rpiihdlhpi", "hybypgi", "bgddgylhyldildg", "alprgabadg", "pgdlhlylrphay", "arbid", "iblryh", "yhpibr", "ragdphggiygpl", "ghphdibaigidbalpa", "yaairyplh", "pgrgbrhpdigaygaly", "gygbhrigddrppylbhg", "bpahyp", "yybhibdhbigh", "giblbprgbaiphhd", "gibbgghayyyipy", "dpraablhyg", "rbppphlid", "aiylbabld", "giapyi", "lpbyihbrdblr", "abhaplbpyagrrpl", "bribrblbbgbhpip", "rhhglhabbapdpi", "bibaddygp", "dhirigg", "rhypdp", "hddbry", "ddapigii", "rlggriblirrlpipyd", "hbydgb", "ggaigdyparhipplia", "ybgbrprdbaaybdpd", "byhblgl", "grbllaiayilpiyi", "gddpr", "bpalaibiypdyrrrhd", "agabggbyppyaribhipa", "airrgliprrdyp", "grggrl", "lrpprbaibydi", "ryriihg", "lrddidi", "pyhiigpllpyagrdppp", "bpppady", "gdlglprdrrdl", "aiyaaibygyyiphpld", "gyiaah", "bpipybpdddg", "glhgaiiigaayldbyib", "ylyiglbghphrapyddh", "dbridybdhbidgrybal", "hpbdiahhhprlbylyd", "ybigd", "pyrbdigprrag", "iyrgyl", "biagga", "yibbghi", "phddyhgip", "gdagyaiarrddrphhllr", "aahyyhlp", "rdggbydlglylbrpblgr", "rbylhldprld", "irlldrlhg", "abardpblgiyphdr", "rbhbhgahpya", "iihgibirhrr", "dglrirbaabirigay", "ldbippbbaibrg", "ypadlhirliyy", "yprrhi", "yigaib", "glgirdprpdlgapbr", "idyyaahdaipdbiddhag", "ghydalgpgyy", "rhdha", "pbldybgibhyprhghl", "blpragyidahdpdihbli", "idrdagpy", "igirllrbapgb", "habgyla", "ribrdbrgd", "hayybgppriphbh", "brapiaillrh", "dpydhadlrb", "ibgdapd", "pydhpbhggpplyagbph", "albaipblldilraaab", "arrryhiyhahabid"]	["rhdha", "pgbaab", "iddaaaabyyyaybiidib", "alibypd", "ylilgadhi", "ygildy", "gibpi"]	TODO
gggggggggggggggggggggggggggggggggggggggggggggggggggggggggggggggggggggggggggmggggggggggggggggggggggggggggggggggggggggggggggggggggggggggggggggggggggggggg	["ggggg", "gggggggggg", "gggggggg", "gggg", "gg", "gggggg", "ggg", "ggggggg", "ggggggggg", "g"]	[]	TODO
tjnk	["tjn", "k", "nk"]	["tjn", "k"]	TODO
joorxolx	["olx", "joo", "rx", "joorx"]	["joorx", "olx"]	TODO
foezpnc	["foezp", "f", "nc", "ezpn", "oezp"]	["foezp", "nc"]	TODO
tbgfxouldgf	["tbgf", "xouldgf", "tbgfx", "tb"]	["tbgf", "xouldgf"]	TODO
